R 800 400
NO ./maps/textures/brick.xpm
SO ./maps/textures/brick.xpm
WE ./maps/textures/brick.xpm
EA ./maps/textures/brick.xpm
S ./maps/textures/brick.xpm
F 225,30,0
111111
000001
100001
1000N1
111111