
        R 1200 800
F  255,255,255 

C 255,          255,         255

NO ./maps/textures/wood.xpm
SO ./maps/textures/brick.xpm
WE ./maps/textures/blue.xpm
EA    ./maps/textures/grey.xpm

S          ./maps/textures/lion.xpm

                   1                 
   11111111111111111111111111111     
   11000000001100000000000000001     
   10010020011100000111100010001     
   1001000000000002011000100011      
 1110110000011100000111100010001     
 10020000000000000000200000000111    
 100000000011000001111111111111      
 111101100011110111                  
    1011001111101 11111111111        
 111100001101  1111                  
 1000020000N111101111111111111111    
 10200000000000001101010010011       
111110111100111100020000000001       
 100000000011  1000000000001111111111
 111000000001  1000010100011         
   1111101111  111111111111          
       101            1              
       101                           
       121                           
       111                           
        1                            